6

1 1 8 2 -8 0 0 255 0 0 -1 1 0

2 1 2 0 -8 196 0 207 0 1 0 1 1

3 1 8 3 -19 56 47 133 0 0 1 2 1

4 1 8 -24 -30 168 96 255 0 1 1 2 1

5 1 2 8 -8 0 0 0 0 1 0 1 1

6 1 -5 0 -8 0 0 0 0 0 0 2 1
